S=========================================================================
..........=...........=.....=.=...=.....=...=.=...=...=.........=.=.......
=.=.=====.===.=.===.=====.===.===.=.===.=.=.=.===.=.===.===.=====.===.=.=.
=.=...=.=...=.=.=.....=...=.........=...=.=.=.=.........=...=.=.......=.=.
=.===.=.=.===.=.=====.=.=.===.===.===.=====.=.=====.=========.=.=====.===.
=...=...=.=.=.=.=...=...=.=...=...=.=.......=.=...=.=.......=...=.=...=...
=.=.=======.===.===.=.===.=.===.===.=.=.=====.===.=.=====.=====.=.===.===.
=.=.........=.=.=.......=.....=.....=.=...=...=.=.....=...=.=.......=.=...
=.=.=======.=.=.=.=.=====.=.=.=======.=.=.===.=.=.=.=.=.===.=.=========.==
=.=.=.......=.=.=.=...=...=.=...=.=...=.=.....=...=.=...=.=.=.........=...
=.===.=====.=.=====.=============.===.=======.=.=.===.=.=.=.===.=========.
=...=.=.......=.....=.=.=...=...=...=...=...=.=.=...=.=.=...........=.....
=.===.=======.=.=.=.=.=.===.===.=.=.=.===.=====.===.=============.=====.==
=.=...=.........=.=.....=.......=.=...=.=...=.....=.=...=.=.=.=...=.....=.
=====.=.=.=====.=====.=========.=====.=.===.=.=.=.===.===.=.=.=.==========
=.=...=.=.=.....=.=.=.=.......................=.=.........=.=.........=...
=.=.=====.=======.=.=====.===.===.=============.=.=====.=.=.=.===========.
=...=.....=...=.=.....=...=.=...=.=...=.....=.=.=...=...=.....=...=.....=.
=.=====.=.=.=.=.===.=======.=.=====.=====.=.=.===========.===.=.=======.=.
=...=...=...=...=.=.....=.=...........=...=.......=.=.......=...=...=.....
=====.=.===.=.===.===.===.=.=====.===.=====.===.===.=.=========.=.=.=.===.
=.=.=.=.=...=.=.=.........=...=.=.=.....=.=.=.....=.=.........=...=.=.=...
=.=.=========.=.=.===.===.=====.=.===.===.=.===.===.=.=======.=.=====.====
=.....=.....=...=...=...=.=...=.=.=.......=.=.....=...=.=.......=...=.....
=====.=.===.===.=.=.=====.=.===.=====.=========.====.==.=.=.===.===.=.=.=.
=.=.=.=.=.......=.=...=.....=.=.....=.=.......=...=...=.=.=.=.=.....=.=.=.
=.=.=.=.=.=========.=====.===.=====.=.===.=.=====.===.=.=====.=.=.===.=.=.
=.=.....=.....=.=.....=.=.=...=.=.....=.=.=.......=...=.........=.=...=.=.
=.===.===.=====.=.=====.=.=.=.=.===.=.=.===.=.===.=.===.===.=.=.===.===.=.
=.....=...=.=.....=...=.=...=.=.=.=.=.=...=.=...=.........=.=.=.....=...=.
=.=======.=.=======.===.=.=====.=.=.=.=.=.=========.=========.=.=======.==
=...=.....=.........=.=.=.....=...=.=...=.=.......=...=...=...=.=.=...=.=.
===.=.=.=.===.===.=.=.=.===.===.=.=.=============.=.===.=====.===.===.=.=.
=...=.=.=.=.....=.=.............=...=...=.=.......=.........=.....=.......
=======.=.=.===.=.===.===.=.=.=.=.=====.=.=.===.=======.=.=.=.===.=====.==
=.....=.=.=.=.=.=.=.=...=.=.=.=.=.....=...=.=...........=.=...=.......=.=.
=.===.=.===.=.=====.=====.=======.=.===.=.=.=.===.=.===.=.=.=====.=.=.===.
=.=.=.......=...=.....=.....=.....=.....=...=.=...=.=...=.=...=...=.=.=...
===.=.=====.===.=====.=.=====.=====.===========.=.=.=.=.=.=======.===.====
=...=.....=.......=.=...=...=.=...=.=.....=.=...=.=.=.=.=.......=.=.=.=...
=.=.=.=.=.=========.===.=.===.=.=.=.=.=.=.=.=.=.=.=.=========.=.===.=====.
=.=.=.=.=.......=...=.=.=.......=.=...=.=.=...=.=.=.=.......=.=...=.=...=.
=.=.=.===========.===.=====.===.===.=======.=.=.=======.=====.=====.===.==
=.=.=.=.....=.....=...=.=.=.=.=...=...=...=.=.=...........=.....=.=...=...
=.===.===.=======.=.===.=.===.===.=.=.=.=.===.===.===.===.=====.=.===.====
=...=...=.........=...=.........=.=.=.=.=...=.=.....=.=.......=...=.......
=.=======.===.=.=====.=.=======.=======.===.=.=========.=.=======.===.===.
=.....=.....=.=.....=...=.=.=.....=.....=...=.=.=...=...=.=...=.=.......=.
=.===========.===.===.===.=.=.=========.===.=.=.=.===.=.=.=.===.=.=.=====.
=.=...=.....=.=.........=...........=.....=...=.=...=.=.=...=.....=.....=.
=.=.===.=====.=============.=.=.=====.=====.===.=.=.=====.===.=======.====
=...=...=.=...=.....=.=.=...=.=.=.=...=...=.=.....=.........=.=.....=...=.
=.=.===.=.=====.=.=.=.=.=======.=.===.=.=.===.=.=======.=.=======.=====.=.
=.=.=.....=...=.=.=...............=.....=.=...=...=.....=...=.......=...=.
=.=.=.===.===.=====.=====.=====.=.=.===.=.=.=========.=.=====.=.=======.=.
=.=...=.=.=.....=...=.......=.=.=.=.=...=.=.=.=.=.=...=.......=.=.=...=.=.
=.=.=.=.=.=.===.===.=.=.===.=.===.=========.=.=.=.=.=.===.===.===.===...=.
=.=.=...=...=.....=.=.=.=.=...=...=...=.=...=...=.=.=.=...=.......=...=.=.
===.=======.===.=.=.===.=.=.=.===.===.=.=.=====.=.=.=====.=======.=.=====.
=...=.=.....=...=.=.=...=...=...=.......=.=.........=.=...=.=...=...=.....
=====.=====.=========.=.=====================.=======.===.=.=.=.=.=======.
=.........=.......=...=.......=.....=.......=.......=.........=...=.......
=====.=======.=====.=.===.===.===.===.===.===========.===.=======.===.====
=...=...=.....=.....=.=.....=...=...=...=...=.=.....=.=.......=.=.......=.
=.=.===.=.=======.=======.=====.===.=====.===.=.=.=======.=====.=======.=.
=.=.......=...........=.......=...........=.....=...=.........=.=.=...=.=.
===.=.===.=.===========.===============.=.=.=.=====.=.=====.===.=.===.===.
=...=.........=...=.........=.=...=.....=...=...=.=.....=.=.........=.=...
=.=========.===.=====.=.=.=.=.===.===.===========.=======.===.=.=.===.====
=....E=.=.=.=.......=.=.=.=...=.....=.......=.=.=.=...=.....=.=.=.....=.=.