====================
S.....=.....=...=...
=.===.=.===.=.=.===.
=.......=...=.=.=...
=========.===.=.=.==
=.=.......=...=.=...
=.=.=====.=.===.===.
=...=.....=.=.=.=...
=====.=====.=.=.=.==
=...........=...=..=
=.===============.==
=...=...........=...
===.=.===.=====.=.=.
=.=...=...=...=...=.
=.=====.===.=.======
=.......=...=...=...
===.=====.=====.=.=.
=...=.........=...=.
=.=====.=====.=.=.==
=.......=.....=.=..E
