====================
S........===========
========.===========
=......=.===========
==.=.=...===========
=..=..=.============
=====.==.===========
=====....===========
=====.==.===========
=====.==.===========
=====.==.===========
=====.==.===========
=====.==.===========
=====.==.===========
=====.==.===========
=====.==.===========
=====.==.===========
=====.==.===========
=====.==.===========
=====.==============