====================
.........===========
========.===========
=......=.===========
==.=.=...===========
=..=..=.============
=====.==.===========
=====....===========
=====.==.===========
=====.==.===========
=====.==.===========
=====.==.===========
=====.==.===========
=====.==.===========
=====.==.===========
=====.==.===========
=====.==.===========
=====.==.===========
=====.==.===========
=====E==============