S====================
............=.......=
=.=.===.===.=====.===
=.=.=.=.=.....=.....=
===.=.=.===.=====.=.=
=.=.=.=...=...=.=.=.=
=.=.=.=.=.=====.=.===
=.=.=.=.=.......=...=
=.=.=.=.=====.=.=.===
=...=.=.....=.=.....=
=.===.=.===.===.===.=
=.=...=.=...=.....=.=
===.===.=.=====.=.===
=.=.....=.....=.=...=
=.=.===.=======.=====
=...=.=.....=...=...=
===.=.=.=======.=.===
=.=...=...=...=.....=
=.=========.=====.=.=
=.=.............=.=.=
=.=========.===.===.=
=...=.=.....=.....=.=
===.=.===.=====.===.=
=.=.........=.......=
=.=.===.=========.===
=.=...=.=.=.=.=.....=
=.=======.=.=.=.=====
=...........=...=...=
=====.=========.===.=
=...=...=...........=
=.=.=.===.=====.===.=
=.=...=...=.....=.=.=
=====.=.=.=======.=.=
=.....=.=.=.......=.=
=====.=.=======.=.=.=
=.=.=.....=.....=...=
=.=.=.=.===.=====.===
=.....=.=.....=.=.=.=
===.===.===.===.=.=.=
=...=.....=.=.......=
===================.E
