S.===================================================================================================
....=.......=...=.=.=.=...................=...=.....=.=.=.......=...........=.......=.....=.........=
===.===.=.=====.=.=.=.=.===.===.=====.=.===.=.=.=.===.=.===.=====.===.=.===.=.===========.=========.=
=.......=...=.=...=...=.=...=.=.=.....=.....=.=.=.........=.........=.=...=.....=...=...=...=...=...=
=.===.===.===.=.===.=.=.=====.=======.=.=.=====.=.===========.=========.=====.=.=.=.===.===.===.=.===
=.=...=.=...........=.......=...=.=...=.=.=.....=.=.............=.....=.=.....=.=.=.........=...=...=
=====.=.=======.=====.===.=====.=.=======.===.=====.=========.=.=.=====.===.===========.===.=.=.===.=
=...=...=.........=.=.=.=.....=.....................=...=.=...=.=.....=...=...=...=.......=...=...=.=
=.===.===.=====.===.=.=.===.=====.=====.=.=.===.=====.=.=.=.===.===.===.===.=====.=====.===.=.===.=.=
=.......=...=...=.......=.....=...=.....=.=.=.........=.=...=.......=...=...............=...=.=.....=
===================================================================================================.E